囗	囗
口	囗
一	一
日	口 一
㇒	㇒
白	日 ㇒
勹	勹
丶	丶
勺	勹 丶
的	白 勺
扌	扌
手	㇒ 扌
戈	戈
我	手 戈
亻	亻
⺈	⺈
亅	亅
八	㇒
小	亅 八
尔	⺈ 小
你	亻 尔
龰	龰
𤴓	一 龰
是	日 𤴓
㇇	㇇
了	㇇ 亅
丿	丿
丆	一 丿
卜	卜
不	丆 卜
𠂇	𠂇
土	土
在	𠂇 亻 土
乚	乚
㇆	㇆
丨	丨
也	乚 ㇆ 丨
他	亻 也
門	門
們	亻 門
我們
㇛	㇛
女	㇛ 丆
子	了 一
好	女 子
冂	冂
二	一
月	冂 二
有	𠂇 月
辶	辶
亠	亠
言	亠 二 口
這	辶 言
人	㇒
亼	人 一
丷	丷
會	亼 口 丨 丷 日
㇉	㇉
灬	灬
馬	一 二 丨 ㇉ 灬
嗎	口 馬
十	一 丨
什	亻 十
广	广
林	林
麻	广 林
幺	幺
麼	麻 幺
什麼
儿	儿
兌	八 口 儿
說	言 兌
她	女 也
木	木
目	口 二
相	木 目
㇃	㇃
心	㇃ 丶
想	相 心
彳	彳
艮	艮
很	彳 艮
刀	㇆ 丿
阝	阝
那	刀 二 阝
从	从
來	木 从
耂	耂
者	耂 日
都	者 阝
固	囗 十 口
個	亻 固
厶	厶
䏍	厶 月
匕	匕
能	䏍 匕
去	土 厶
禾	禾
和	禾 口
古	十 口
⺙	⺙
故	古 ⺙
做	亻 故
⺊	⺊
上	⺊ 一
氵	氵
㇏	㇏
又	㇇ ㇏
沒	氵 ㇆ 又
沒有
龵	龵
看	龵 目
乍	丿 一 丨 二
怎	乍 心
怎麼
王	王
見	目 儿
現	王 見
現在
黑	黑
占	⺊ 口
點	黑 占
尸	尸
尼	尸 匕
呢	口 尼
大	人 一
太	大 丶
衤	衤
里	里
裡	衤 里
㔿	㔿
耳	㔿 二
𢛳	𢛳
聽	耳 王 𢛳
隹	隹
誰	言 隹
夕	夕
多	夕
寸	寸
寺	土 寸
時	日 寺
ユ	ユ
矢	矢
候	亻 丨 ユ 矢
時候
下	一 卜
身	㇆ 丨 ㇒ 二 丿
射	身 寸
謝	言 射
謝謝
⺧	⺧
先	⺧ 儿
龶	龶
生	龶 ㇒
先生
士	十 一
喜	士 口 丷 一 口
艹	艹
吅	吅
雚	艹 吅 隹
欠	欠
歡	雚 欠
喜歡
東	木 日
兀	一 儿
西	兀 囗
東西
㇙	㇙
丩	丨 ㇙
叫	口 丩
爫	爫
冖	冖
夂	夂
愛	爫 冖 心 夂
𠂉	丿 一
㇗	㇗
㐄	十 ㇗ 丨
年	𠂉 㐄
青	青
請	言 青
回	囗
丄	丨 一
工	一 丄
作	亻 乍
工作
全	人 王
金	全 丷
戔	戔
錢	金 戔
㇠	㇠
乞	丿 一 ㇠
吃	口 乞
廾	廾
开	一 廾
開	門 开
宀	宀
勿	勹 ㇒
冫	冫
豕	一 勿 冫
家	宀 豕
哪	口 那
朋	月
友	𠂇 又
朋友
媽	女 馬
媽媽
亽	人 丶
今	亽 ㇇
天	一 大
今天
幾	戈 幺
乂	乂
父	八 乂
巴	巴
爸	父 巴
爸爸
止	止
此	止 匕
些	此 二
羊	羊
水	水
永	水 丶
羕	羊 永
樣	木 羕
怎麼樣
對	丷 一 羊 寸
走	土 龰
己	己
起	走 己
對不起
主	王 丶
住	亻 主
三	一 二
冋	冂 口
高	亠 口 冋
臼	臼
興	臼 冂 一 口 一 八
高興
罒	罒
貝	貝
買	罒 貝
匚	匚
殳	殳
殹	匚 矢 殳
酉	酉
醫	殹 酉
醫生
兒	臼 儿
哪兒
字	宀 子
名	夕 口
名字
忍	刀 丶 心
認	言 忍
立	立
音	立 日
識	言 音 戈
認識
坐	土 从
曰	曰
曷	曰 勹 人 ㇗
喝	口 曷
舄	臼 勹 灬
寫	宀 舄
号	口 一 ㇉
虍	虍
几	几
虎	虍 几
號	号 虎
犭	犭
句	勹 口
狗	犭 句
厂	厂
歲	止 厂 戈 一 小 丿
看見
丁	一 亅
打	扌 丁
巾	巾
帀	一 巾
雨	帀 冫
电	日 丨 乚
電	雨 电
舌	舌
話	言 舌
打電話
田	田
畏	田 一 乚 冫
喂	口 畏
兒子
覀	覀
示	二 小
票	覀 示
漂	氵 票
亮	亠 口 冖 几
漂亮
分	八 刀
童	立 里
鐘	金 童
分鐘
冉	冂 土
再	一 冉
再見
本	木 一
明	日 月
明天
少	小 丿
多少
鬼	鬼
塊	土 鬼
女兒
且	月 一
姐	女 且
小姐
𧘇	㇒ ㇗ 冫
衣	亠 𧘇
卩	卩
𠬝	卩 又
服	月 𠬝
衣服
爻	爻
𦥯	臼 爻 冖
學	𦥯 子
六	亠 八
交	六 乂
校	木 交
學校
景	日 亠 口 小
彡	彡
影	景 彡
電影
聿	聿
書	聿 日
四	囗 儿
力	㇆ 丿
五	一 力 一
元	二 儿
完	宀 元
院	阝 完
醫院
關	門 幺 關
糸	糸
系	㇒ 糸
沒關系
升	艹 ㇒
飛	升
機	木 幾
飛機
礻	礻
視	礻 見
電視
賣	士 罒 貝
讀	言 賣
後	彳 幺 夂
'二
囬	囗 丨 '二
面	丆 囬
後面
昨	日 乍
昨天
垂	㇒ 十 士 艹
睡	目 垂
覺	𦥯 見
睡覺
老	耂 匕
㠯	㠯
𠂤	㠯 丶
師	𠂤 帀
老師
星	日 生
甘	甘
其	甘 一 八
期	其 月
星期
豸	豸
苗	艹 田
貓	豸 苗
巛	巛
腦	月 巛 囗 丶 乂
電腦
㇈	㇈
埶	土 八 土 丿 ㇈ 丶
熱	埶 灬
學生
干	一 十
午	干 ㇒
下午
羽	羽
習	羽 白
學習
龴	龴
令	人 丶 龴
冷	冫 令
各	夂 口
客	宀 各
气	气
米	木 丷
氣	气 米
不客氣
䒑	丷 一
刂	刂
刖	月 刂
前	䒑 刖
前面
中	口 丨
戓	戈 口
或	戓 一
國	囗 或
中國
七	乚 一
采	爫 木
菜	艹 采
桌	⺊ 日 木
桌子
凵	凵
山	丨 凵
出	山
租	禾 且
車	二 丨 日
出租車
天氣
茶	艹 人 十 八
九	丿 ㇈
冏	冂 八 口
商	亠 丷 冏
店	广 占
商店
可	丁 口
奇	大 可
椅	木 奇
椅子
同	冂 一 口
同學
一點
頁	丆 貝
頻	止 小 丿 頁
蘋	艹 頻
果	田 木
蘋果
彐	彐
飠	人 丨 彐 乚 丶 丶
⺁	⺁
反	⺁ 又
飯	飠 反
飯店
中午
上午
水果
杯	木 不
杯子
下雨
米飯
北	匕
京	亠 口 小
北京
漢	氵 艹 口 丨 人 二
吾	一 力 一 口
語	言 吾
漢語
尢	尢
尤	尢 丶
就	京 尤
要	覀 女
知	矢 口
自	目 丶
首	䒑 自
道	辶 首
知道
吧	口 巴
𠫓	一 厶
至	𠫓 土
到	至 刂
睘	罒 一 口 ㇒ ㇗ 冫
還	辶 睘
襄	衣 吅 丨 二 一
讓	言 襄
糹	糹
合	亼 口
給	糹 合
咼	冂 ㇆ 冂 口
過	辶 咼
㝵	日 一 寸
得	彳 㝵
具	目 一 八
真	十 具
著	艹 者
以	乚 丶 人
可以
別	口 丿 ㇆ 刂
告	⺧ 口
丅	一 丨
斤	⺁ 丅
斥	斤 丶
訴	言 斥
告訴
因	囗 大
為	丿 丶 ㇆ 灬
因為
忄	忄
𠃍	𠃍
夬	大 𠃍
快	忄 夬
旦	日 一
但	亻 旦
但是
已	己
巠	一 巛 工
經	糹 巠
已經
為什麼
覺得
它	宀 匕
從	彳 从 龰
找	扌 戈
取	耳 又
最	曰 取
可能
次	冫 欠
亥	亠 丨 ㇙ 人
孩	子 亥
孩子
戶	丿 尸
所	戶 斤
所以
兩	一 巾 从
昔	艹 一 日
錯	金 昔
⺮	⺮
等	⺮ 寺
題	是 頁
問	門 口
問題
一起
台	厶 口
始	女 台
開始
間	門 日
時間
⺺	⺺
事	十 口 丨 ⺺ 亅
情	忄 青
事情
一下
非	非
⺌	⺌
龸	⺌ 冖
吊	口 巾
常	龸 吊
非常
布	𠂇 巾
希	乂 布
匸	匸
肓	匸 丶 月
望	肓 王
希望
淮	氵 隹
準	淮 十
用	用
備	亻 艹 厂 用
準備
比	匕
牛	牛
件	亻 牛
意	音 心
思	田 心
意思
弓	弓
第	⺮ 弓 丨 ㇒
第一
進	辶 隹
大家
亲	立 十 小
新	亲 斤
您	你 心
穴	穴
㇜	㇜
牙	一 ㇜ 亅 丿
穿	穴 牙
关	丷 一 大
送	辶 关
玩	王 元
長	長
小時
⺀	⺀
母	㇗ ㇆ ⺀ 一
每	𠂉 母
公	八 厶
司	㇆ 一 口
公司
圭	圭
封	圭 寸
帛	白 巾
幫	封 帛
助	且 力
幫助
免	⺈ 口 丨 乚
晚	日 免
晚上
說話
亡	匸 丶
忙	忄 亡
户	户
方	方
房	户 方
房間
⻊	⻊
路	⻊ 各
董	艹 ㇒ 十 里
懂	忄 董
正	一 止
正在
夭	㇒ 大
笑	⺮ 夭
袁	土 口 ㇒ ㇗  冫
遠	辶 袁
妻	十 ⺺ 女
妻子
丈	十 乂
夫	人 二
丈夫
禸	禸
离	亠 凵 乂 禸
離	离 隹
往	彳 主
男	田 力
眼	目 艮
睛	目 青
眼睛
樂	白 幺 木
快樂
虫	虫
虽	口 虫
雖	虽 隹
犬	犬
肰	月 犬
然	肰 灬
雖然
早	日 十
早上
藥	艹 樂
骨	骨
井	丿 丨 二
曲	井 凵
豆	豆
豊	曲 豆
體	骨 豊
身體
加	力 口
咖	口 加
啡	口 非
咖啡
休	亻 木
息	自 心
休息
外	夕 卜
生日
哥	可
哥哥
手機
洗	氵 先
兆	儿 冫
跳	⻊ 兆
卌	丨 一
舛	舛
舞	𠂉 卌 一 舛
跳舞
弟	丷 弓 丿 丨
弟弟
未	木 一
妹	女 未
妹妹
紅	糹 工
曼	日 罒 又
慢	忄 曼
近	辶 斤
姐姐
介	人 丿 丨
召	刀 口
紹	糹 召
介紹
魚	⺈ 田 灬
累	田 糸
課	言 果
玨	玨
班	玨 丿 丶
上班
旁	亠 丷 冖 方
臱	自 穴 方
邊	辶 臱
旁邊
軍	冖 車
運	辶 軍
千	㇒ 十
重	千 里
動	重 力
運動
去年
幸	土 丷 干
報	幸 𠬝
氏	氏
紙	糹 氏
報紙
文	亠 乂
彥	文 厂 彡
顏	彥 頁
色	⺈ 巴
顏色
昜	日 一 勿
場	土 昜
機場
昌	昌
唱	口 昌
歌	哥 欠
唱歌
好吃
丂	一 ㇉
考	耂 丂
弋	弋
式	弋 工
試	言 式
考試
左	𠂇 工
左邊
姓	女 生
百	一 白
雪	雨 彐
貴	中 一 貝
疒	疒
丙	一 人 冂
病	疒 丙
生病
斿	方 丿 一 子
游	氵 斿
泳	氵 永
游泳
㇎	㇎
乃	㇎ 丿
奶	女 乃
牛奶
右	𠂇 口
右邊
更	一 日 丨 乂
便	亻 更
宜	宀 且
便宜
龷	艹 一
共	龷 八
汽	氵 气
公共汽車
床	广 木
起床
臣	臣
皿	皿
監	臣 丿 一 丶 皿
籃	⺮ 監
氺	氺
求	𠂇 丶 氺
球	王 求
打籃球
奚	爫 幺 大
雞	奚 隹
疋	疋
蛋	疋 虫
雞蛋
易	日 勿
踢	⻊ 易
足	口 龰
踢足球
零	雨 令
表	龶 𧘇
手表
旅	方 丿 一 氏
旅游
矛	矛
务	夂 力
務	矛 务
員	口 貝
服務員
賓	宀 一 小 丿 貝
官	宀 㠯
館	飠 官
賓館
孝	耂 子
教	孝 ⺙
室	宀 至
教室
巳	巳
包	勹 巳
跑	⻊ 包
步	止 小 丿
跑步
侌	人 丶 ㇇ 二 厶
陰	阝 侌
条	夂 十 小
條	亻 丨 条
面條
鉛	金 几 口
筆	⺮ 聿
鉛筆
火	人 ㇒
站	立 占
火車站
瓜	瓜
西瓜
仌	仌
肉	仌 冂
羊肉
晴	日 青
阿	阝 可
啊	口 阿
把	扌 巴
如	女 口
如果
只	口 八
皮	丿 ㇆ 丨 ㇇ ㇏
被	衤 皮
跟	⻊ 艮
自己
象	⺈ 口 丨 豕
像	亻 象
𦉫	冂 丨
而	丆 𦉫
需	雨 而
需要
䧹	广 亻 隹
應	䧹 心
該	言 亥
應該
起來
才	𠂇 ㇒
拿	合 手
廿	廿
帶	儿 廿 冖 巾
然後
一樣
當	⺌ 冖 口 田
當然
信	亻 言
相信
認為
明白
直	十 目 一
一直
地	土 也
地方
離開
定	宀 𤴓
一定
還是
癶	癶
發	癶 弓 殳
發現
而且
必	心 丿
須	彡 頁
必須
放	方 ⺙
為了
向	宀 口
位	亻 立
種	禾 重
后	⺁ 一 口
最后
其他
記	言 几
記得
或者
過去
詹	⺈ 厂 八 言
擔	扌 詹
擔心
以前
世	㇗ 廿
界	田 介
世界
重要
別人
機會
張	弓 長
妾	立 女
接	扌 妾
賽	宀 二 一 八 貝
比賽
關系
馬上
決	氵 夬
決定
仒	人 ⺀
於	方 仒
關於
難	口 夫 廿 隹
尞	大 丷 日 小
瞭	目 尞
角	⺈ 用
解	角 刀 牛
瞭解
吉	士 口
結	糹 吉
束	木 口
結束
清	氵 青
楚	林 疋
清楚
原	厂 白 小
願	原 頁
願意
化	亻 匕
花	艹 化
昭	日 刀 口
照	昭 灬
㇕	㇕
片	丿 丄 ㇕
照片
卬	㇒ ㇗ 卩
迎	辶 卬
歡迎
悤	囗 丶 夂 心
總	糹 悤
總是
觜	止 匕 角
嘴	口 觜
厽	厽
㐱	人 彡
參	厽 㐱
參加
辡	辡
辦	辡 力
法	氵 去
辦法
巽	巳 共
選	辶 巽
睪	罒 土 丷 干
擇	扌 睪
選擇
褱	衣 罒 氺
壞	土 褱
算	⺮ 目 一 丿 丨
打算
特	牛 寺
特別
注	氵 主
注意
貫	囗 十 貝
實	宀 貫
其實
小心
久	勹 ㇏
只有
冓	井 再
講	言 冓
故事
奐	⺈ 冂 八 大
換	扌 奐
昏	氏 日
婚	女 昏
結婚
段	丨 ㇒ 二 一 殳
奴	女 又
努	奴 力
努力
害	宀 丄 二 口
怕	忄 白
害怕
岡	冂 丷 一 山
剛	岡 刂
剛才
即	白 匕 卩
節	⺮ 即
節目
輛	車 兩
禺	冂 二 丨 禸
萬	艹 禺
解決
辦公室
圣	又 土
怪	忄 圣
奇怪
同意
䖒	虍 豆
戲	䖒 戈
游戲
幫忙
國家
最近
声	士 尸 丨
殸	声 殳
聲	殸 耳
聲音
可愛
万	一 丿 ㇆
成	万 戈
完成
半	二 丨 丷
要求
余	人 干 小
除	阝 余
除了
谷	谷
容	宀 谷
容易
僉	亼 口 人
臉	月 僉
簡	⺮ 間
單	吅 田 十
簡單
檢	木 僉
查	木 旦
檢查
音樂
戉	匚 戈
越	走 戉
雇	户 隹
顧	雇 頁
照顧
聰	耳 悤
聰明
甜	舌 甘
突	穴 犬
突然
冬	夂 ⺀
終	糹 冬
終於
舟	舟
船	舟 几 口
答	⺮ 合
回答
禮	礻 豊
物	牛 勿
禮物
頭	豆 頁
頭發
關心
卻	谷 卩
腳	月 卻
生氣
哭	吅 犬
畫	聿 田 一
輕	車 巠
年輕
退	辶 艮
腿	月 退
忘	亡 心
忘記
般	舟 殳
搬	扌 般
婁	口 十 女
樓	木 婁
遇	辶 禺
遇到
聞	門 耳
新聞
較	車 交
比較
雔	雔
雙	雔 又
見面
經常
城	土 成
市	亠 巾
城市
一會兒
付	亻 寸
附	阝 付
附近
借	亻 昔
乡	㇛ 丿
郎	丨 彐 乚 丶 阝
鄉	乡 郎
響	鄉 音
影響
認真
差	羊 工
銀	金 艮
亍	二 亅
行	彳 亍
銀行
安	宀 女
⺕	⺕
爭	爫 ⺕ 亅
靜	青 爭
安靜
多麼
餓	飠 我
根	木 艮
豦	虍 豕
據	扌 豦
根據
乎	㇒ 𠂇 丷
幾乎
後來
動物
一邊
舍	人 干 口
㇖	㇖
予	龴 ㇖ 亅
舒	舍 予
舒服
一般
尗	⺊ 一 小
叔	尗 又
叔叔
疼	疒 冬
犀	尸 氺 牛
遲	辶 犀
遲到
秝	秝
厤	厂 秝
歷	厤 止
史	中 乂
歷史
卑	冂 二 丨 丶 十
啤	口 卑
酒	氵 酉
啤酒
短	矢 豆
經過
周	田 口
末	木 一
周末
慣	忄 貫
習慣
園	囗 袁
公園
龺	十 日 十
乾	龺 乞
淨	氵 爭
乾淨
鳥	白 ㇉ 一 灬
廴	廴
建	廴 聿
健	亻 建
隶	隶
康	广 隶
健康
尌	十 豆 寸
樹	木 尌
羔	羊 灬
糕	米 羔
蛋糕
客人
義	羊 手 戈
議	言 義
會議
奶奶
庫	广 車
褲	衤 庫
褲子
粦	米 舛
鄰	粦 阝
居	尸 古
鄰居
理	王 里
經理
曾	丷 口 丨 丷 日
層	尸 曾
登	癶 豆
燈	火 登
柬	木 口 丨 丷
練	糹 柬
練習
耶	耳 阝
爺	父 耶
爺爺
藍	艹 監
難過
中間
冃	冂 二
冒	冃 目
帽	巾 冒
帽子
司機
舊	艹 隹 臼
滿	氵 廿 巾 从
滿意
騎	馬 奇
陽	阝 昜
太陽
亟	㇇ 亅 口 又 一
極	木 亟
主要
同事
丌	丌
畀	田 丌
鼻	自 畀
鼻子
䜌	糹 糸 言
變	䜌 ⺙
變化
及	㇎ 丿 ㇏
級	糹 及
年級
環	王 睘
竟	音 儿
境	土 竟
環境
胖	月 半
啚	口 十 回
圖	囗 啚
地圖
面包
郵	垂 阝
電子郵件
朵	几 木
耳朵
君	⺕ 丨 口
裙	衤 君
裙子
鮮	魚 羊
新鮮
放心
卯	卯
聊	耳 卯
聊天
南	十 冂 丷 干
熱情
卡	上 卜
信用卡
梯	木 弟
電梯
方便
洗手間
品	品
喿	品 木
澡	氵 喿
洗澡
飲	飠 欠
斗	斗
料	米 斗
飲料
校長
平	干 丷
水平
業	丷 一 木
作業
親	亲 見
襯	衤 親
衫	衤 彡
襯衫
責	龶 貝
績	糹 責
成績
石	石
宛	宀 夕 乚 ㇆
碗	石 宛
夷	大 弓
姨	女 夷
阿姨
圖書館
文化
彑	彑
彔	彑 氺
綠	糹 彔
帚	彐 冖 巾
掃	扌 帚
打掃
草	艹 早
冰	冫 水
箱	⺮ 相
冰箱
數	婁 ⺙
數學
自行車
刍	⺈ 彐
急	刍 心
著急
叟	臼 丨 又
瘦	疒 叟
提	扌 是
提高
起飛
委	禾 女
矮	矢 委
鐵	金 土 戈 口 王
地鐵
育	亠 厶 月
體育
刻	亥 刂
蒦	艹 隹 又
護	言 蒦
護照
節日
盤	般 皿
盤子
一共
并	丷 一 廾
瓦	瓦
瓶	并 瓦
瓶子
街	行 圭
街道
鍛	金 段
煉	火 柬
鍛煉
咸	厂 戈 一 口
感	咸 心
感冒
愛好
超	走 召
超市
月亮
飽	飠 包
有名
香	禾 日
焦	隹 灬
蕉	艹 焦
香蕉
筆記本
夏	一 丶 目 夂
菜單
北方
罔	冂 丷 一 匸 丶
網	糹 罔
上網
季	禾 子
季節
渴	氵 曷
垚	垚
堯	垚 一 儿
燒	火 堯
發燒
不但
空	穴 工
調	言 周
空調
照相機
𡗗	一 二 丨 八
春	𡗗 日
𠈌	𠈌
傘	人 十 𠈌
公斤
個子
熊	能 灬
熊貓
刷	尸 巾 刂
刷牙
复	丿 一 日 夂
復	彳 复
復習
コ	コ
叚	尸 二 コ 又
假	亻 叚
請假
中文
秋	禾 火
句子
李	木 子
行李箱
筷	⺮ 快
筷子
革	革
鞋	革 圭
皮鞋
爪	爪
爬	爪 巴
爬山
板	木 反
黑板
趣	走 取
感興趣
詞	言 司
典	曲 八
詞典
留	卯 田
留學
䖝	㇒ 虫
風	几 䖝
颳	風 舌
颳風
黃	廿 一 田 八
河	氵 可
黃河
歹	歹
死	歹 匕
所有
許	言 午
也許
不過
發生
切	七 刀
一切
抱	扌 包
兼	䒑 一 丨 八 ⺕
歉	兼 欠
抱歉
感覺
肯	止 月
肯定
奉	一 二 丨 八 二 丨
棒	木 奉
以為
卓	⺊ 日 十
掉	扌 卓
活	氵 舌
生活
㇝	㇝
之	丶 ㇇ ㇝
壬	㇒ 士
任	亻 壬
何	亻 可
任何
與	臼 己 丨 一 八
弄	王 艹
㡭	㇗ 一 幺
繼	糹 㡭
續	糹 賣
繼續
夠	多 句
父親
完全
可是
炎	炎
談	言 炎
好像
敬	艹 勹 口 ⺙
警	敬 言
祭	月 卩 示
察	宀 祭
警察
呀	口 牙
兄	口 儿
況	氵 兄
情況
只要
份	亻 分
氐	氏 丶
底	广 氐
到底
成為
永遠
安全
計	言 十
劃	畫 刂
計劃
倆	亻 兩
亭	亠 口 冖 一 亅
停	亻 亭
感謝
敢	一 丨 耳 ⺙
從來
贏	匸 丶 口 月 几 貝
肖	⺌ 月
消	氵 肖
消息
拉	扌 立
原因
連	辶 車
隺	巾 隹
確	石 隺
確實
廷	廴 ㇒ 士
挺	扌 廷
呆	口 木
保	亻 呆
証	言 正
保証
受	爫 冖 又
接受
改	己 ⺙
改變
煩	火 頁
麻煩
出現
管	⺮ 官
不管
匹	匚 儿
甚	甘 匹
甚至
保護
真正
結果
當時
至少
律	彳 聿
律師
寅	宀 一 二 丨 凵 八
演	氵 寅
表演
無	𠂉 卌 一 灬
猜	犭 青
咱	口 自
咱們
進行
入	入
內	入 冂
否	不 口
是否
調查
功	工 力
成功
慮	虍 思
考慮
約	糹 勺
約會
甬	龴 用
通	辶 甬
通過
開心
母親
主意
倒	亻 到
釆	釆
釋	釆 睪
解釋
丱	丱
聯	耳 幺 丱
聯系
証明
叩	口 卩
命	亼 叩
生命
難道
由	二 丨 凵
旨	匕 日
指	扌 旨
厄	厂 乚 ㇆
危	⺈ 厄
險	阝 僉
危險
討	言 寸
猒	日 月 犬
厭	厂 猒
討厭
醒	酉 星
樣子
有趣
咅	立 口
部	咅 阝
部分
理解
任務
吏	十 口 丨 乂
使	亻 吏
專	十 日 丨 寸
轉	車 專
尃	十 用 丶 寸
博	十 尃
博士
臤	臣 又
緊	臤 糸
緊張
棄	亠 厶 山 一 木
放棄
旡	旡
既	白 匕 旡
概	木 既
大概
重新
其中
來自
本來
业	丨 丷 一
並	䒑 业
並且
直接
對於
正常
扁	户 冂 艹
遍	辶 扁
冷靜
方法
扔	扌 乃
能力
另	口 力
另外
髟	髟
松	木 八 厶
鬆	髟 松
放鬆
丟	王 厶
負	⺈ 貝
負責
夢	艹 罒 冖 夕
𢦏	土 戈
異	田 艹 一 八
戴	𢦏 異
吴	口 一 大
誤	言 吴
錯誤
遀	辶 月 𠂇 工
隨	阝 遀
隨便
經歷
支	十 又
持	扌 寺
支持
建議
則	貝 刂
否則
光	⺌ 兀
排	扌 非
安排
龠	龠
鑰	金 龠
匙	是 匕
鑰匙
信息
全部
首先
堅	臤 土
堅持
生意
即使
処	夂 几
處	虍 処
到處
挂	扌 圭
道歉
憐	忄 粦
可憐
實在
騙	馬 扁
諒	言 京
原諒
亂	爫 龴 冂 厶 又 乚
差不多
研	石 开
究	穴 九
研究
憂	一 丿 月 冖 心 夂
擾	扌 憂
打擾
正確
收	丩 ⺙
秒	禾 少
同時
供	亻 共
提供
俞	人 一 月 刂
輸	車 俞
碼	石 馬
號碼
座	广 坐
比如
嚴	吅 厂 一 丨 耳 ⺙
嚴重
脫	月 兌
陪	阝 咅
法律
值	亻 直
值得
使用
方面
原來
侖	人 一 冂 艹
論	言 侖
討論
說明
仍	亻 乃
仍然
動作
受到
旱	日 干
趕	走 旱
懷	忄 褱
疑	匕 矢 龴 疋
懷疑
巨	匚 コ
拒	扌 巨
絕	糹 刀 巴
拒絕
演員
破	石 皮
因此
案	安 木
答案
活動
既然
通知
不得不
無論
啇	亠 丷 欠 子
適	辶 啇
適合
失	夫 ㇒
失望
允	厶 儿
允許
意見
獲	犭 蒦
獲得
要是
敫	白 方 ⺙
邀	辶 敫
邀請
⺻	⺻
盡	⺻ 灬 皿
儘	亻 盡
儘管
良	艮 丶
浪	氵 良
弗	弓 丿 丨
費	弗 貝
浪費
敗	貝 ⺙
失敗
責任
美	羊 大
丽	一 冂 丶
鹿	鹿
麗	丽 鹿
美麗
壓	厭 土
壓力
味	口 未
味道
厲	厂 萬
厲害
出發
奮	大 隹 田
興奮
觀	雚 見
眾	罒 亻 从
觀眾
反對
精	米 青
彩	采 彡
精彩
感情
演出
愉	忄 俞
愉快
開玩笑
雜	亠 从 木 隹
志	士 心
雜志
合適
黄	艹 一 二 丨 凵 八
廣	广 黄
廣告
自然
⺳	⺳
罙	⺳ 木
深	氵 罙
短信
地球
帥	𠂤 巾
推	扌 隹
鍵	金 建
關鍵
究竟
巩	工 几 丶
恐	巩 心
恐怕
尚	⺌ 冂 口
躺	身 尚
乑	乑
聚	取 乑
聚會
方向
畐	一 口 田
福	礻 畐
幸福
接著
技	扌 支
术	木 丶
術	行 术
技術
困	囗 木
困難
正好
提醒
旅行
激	氵 敫
激動
喬	㇒ 大 口 冂 口
驕	馬 喬
敖	龶 一 丿 ㇆ ⺙
傲	亻 敖
驕傲
毛	㇒ 二 乚
許多
川	川
順	川 頁
利	禾 刂
順利
職	耳 音 戈
職業
賺	貝 兼
址	土 止
地址
於是
拾	扌 合
收拾
韋	韋
圍	囗 韋
周圍
愛情
酋	丷 酉
尊	酋 寸
尊重
十分
授	扌 受
教授
超過
寄	宀 奇
順便
無聊
目的
低	亻 氐
乘	禾 北
剩	乘 刂
複	衤 复
複雜
社	礻 土
社會
故意
好處
竟然
表示
印	㇒ ㇗ 一 卩
印象
出生
估	亻 古
估計
地點
輕鬆
作用
舉	臼 己 丨 一 八 二
伙	亻 火
小伙子
著名
免費
傷	亻 丿 一 日 勹 ㇒
傷心
記者
仔	亻 子
細	糹 田
仔細
巧	工 丂
克	古 儿
巧克力
辛	立 十
辣	辛 束
互	一 彑
互相
廁	广 則
廁所
呈	口 王
程	禾 呈
過程
申	日 丨
申請
引	弓 丨
引起
𠄌	𠄌
乀	乀
展	 尸 龷 𠄌 丿 乀
發展
畢	田 一 二 丨 艹
畢業
正式
廚	广 尌
廚房
專業
吸	口 及
吸引
心情
祝	礻 兄
賀	加 貝
祝賀
條件
千萬
唐	广 ⺺ 口
糖	米 唐
趟	走 尚
由於
密	宀 心 丿 山
密碼
倍	亻 咅
擦	扌 察
尤其
驗	馬 僉
經驗
盒	合 皿
盒子
乾杯
看法
髒	冂 ㇆ 月 艹 歹 匕 廾
藝	艹 土 八 丿 ㇈ 丶 二 厶
藝術
速	辶 束
度	广 廿 又
速度
勇	龴 男
勇敢
數字
斬	車 斤
暫	斬 日
暫時
優	亻 憂
秀	禾 乃
優秀
笑話
惜	忄 昔
可惜
省	少 目
笨	⺮ 本
科	禾 斗
科學
歺	歺
食	食
餐	歺 又 食
廳	广 聽
餐廳
距	⻊ 巨
距離
囱	囗 丶 夂
窗	穴 囱
窗戶
空氣
護士
悔	忄 每
後悔
大約
內容
規	夫 見
規定
效	交 ⺙
效果
現金
兒童
篇	⺮ 扁
漫	氵 曼
浪漫
態	能 心
態度
自信
驚	敬 馬
吃驚
孰	亠 口 子 丿 ㇈ 丶
熟	孰 灬
悉	釆 心
熟悉
按	扌 安
按照
紀	糹 己
世紀
憶	忄 意
回憶
相同
重點
教育
受不了
胃	田 月
膚	虍 胃
皮膚
區	匚 品
區別
左右
陽光
章	立 早
文章
語言
標	木 票
標準
管理
誤會
橋	木 喬
舉行
肚	月 土
肚子
堇	廿 口 丨 王
僅	亻 堇
不僅
餅	飠 并
餅乾
際	阝 祭
國際
信心
抬	扌 台
竞	立 口 儿
競	竞
競爭
湯	氵 昜
作家
誠	言 成
誠實
顧客
存	𠂇 仔
扮	扌 分
打扮
㐬	亠 厶 儿 丨
流	氵 㐬
交流
齒	齒
齡	齒 令
年齡
小說
符	⺮ 付
符合
交通
共同
稍	禾 肖
微	彳 山 ⺙ 一 几
稍微
增	土 曾
增加
攴	攴
敲	高 攴
適應
苦	艹 古
辛苦
然而
耐	而 寸
耐心
爿	爿
將	爿 月 寸
將來
沙	氵 少
沙發
